let level1 = `
00000000000000000000000000000000000000000000
01110111111111111111111111111111111111111110
01001000000000000000000000000000000000000010
01000000000000000000000000000000000000000010
01000000000000000000000000000000000000000010
01000000000000000000000000000000000000000010
01000000000000000000000000000000000000000010
01000000000000000000000000000000000000000010
01000000000000000000000000000000000000000010
01000000000000000000000000000000000000000010
01000000000000000000000000000000000000000010
01000000000000000000000000000000000000000010
01000000000000000000000000000000000000000010
01000000000000000000000000000000000000000010
01000000000000000000000000000000000000000010
01000000000000000000000000000000000000000010
01000000000000000000000000000000000000000010
01000000000000000000000000000000000000000010
01000000000000000000000000000000000000000010
01000000000000000000000000000000000000000010
01000000000000000000000000000000000000000010
01000000000000000000000000000000000000000010
01001000000000000000000000000000000000000010
01110111111111111111111111111111111111111110
00000000000000000000000000000000000000000000 `;

level1_length = 44;
level1_height = 25;